-23
23
-10
14
00000000000000000000000000000000000000000000000
00000000000000000000000000000000000000000000000
01111111111111111111111111111111111111111111110
01000000000000000000000000000000000000000000010
01000000000000000000000000000000000000000000010
01000000000000000000000000000000000000000000010
01000000000000000000000000000000000000000000010
01000000000000000000000000000000000000000000010
01000000000000000000000000000000000000000000010
01000000000000000000000000000000000000000000010
01000000000000000000000000000000011000000000010
01000000000000000000000000000000000000000000010
01000000000010000000000000111111110000000000010
01000000000000000000000000111111110000000000010
01000000000000100000000001111111110000000000010
01000000000000000000000001111111110000000000010
01000000000000000000000001111111110000000000010
01000000000000000000000000111111110000000000010
01000000000000000000000000000000000000000000010
01000000000000000000000000000000000000000000010
01000000000000000000000000000000000000000000010
01000000000000000000000000000000000000000000010
01000000000000000000000000000000000000000000010
01000000000000000000000000000000000000000000010
01111111111111111111111111111111111111111111110
